#####################
#A       #         B#
# ####   # ##########
#      ###          #
####  ####  #########
#   #     #  ##     #
#   # #   #  ##     #
#   # #   #  ##     #
#   # #   #  ##     #
#   # #   #  ##     #
#   # #   #         #
#   # #####  ##     #
#   #  ####  ##     #
#   #   #######     #
#   #    ##  ##     #
#   #    ##  ##     #
#                   #
#                   #
#                   #
#####################