#####################
#A       #         B#
# ####   # ##########
#      ###          #
#    #####  #########
#         #  ##     #
#   # #   #  ##     #
#   # #   #  ##     #
#   # #   #  ##     #
#   # #   #  ##     #
#   # #   #         #
#   # #####  ##     #
#   #  ####  ##     #
#   #   #######     #
#   #    ##  ##     #
#   #    ##  ##     #
#   #               #
#   #               #
#                   #
#####################