#####################
#A       #         B#
# ####   # ##########
#      ###          #
####  ###   #########
#   #     #         #
#   #     #         #
#   #     #         #
#   #     #         #
#   #     #         #
#   #     #         #
#   #     #         #
#   #     #         #
#   #     #         #
#   #     #         #
#   #     #         #
#                   #
#                   #
#                   #
#####################