#####################
#A       #         B#
# ####   # ##########
#      ###          #
#  #######  #########
#         #  ##     #
#  #      #  ##     #
#  #  #   #  ##     #
#  #  #   #  ##     #
#  #  #   #  ##     #
#  #  #   #         #
#  #  #####  ##     #
#  #   ####  ##     #
#   #   #######     #
#   #    ##  ##     #
#   #    ##  ##     #
#   #               #
#   #               #
#                   #
#####################